1111111
1100011
1000001
100S001
1000001
1100011
1111111