1111111
1100011
1000001
100W001
1000001
1100011
1111111